{
  "width": 60,
  "height": 60,
  "resolution": 0.05,
  "cells": [
    "............................................................",
    "............................................................",
    "............................................................",
    "..........#.................................................",
    "....S.....#.................................................",
    "..........#.................................................",
    "..........#.................................................",
    "..........#.................................................",
    "..........#...#####.........................................",
    "..........#...#####.........................................",
    "..........#.................................................",
    "..........#.................................................",
    "#########.#.................................................",
    "..........#.................................................",
    "..........#.................................................",
    "..........#.................................................",
    "..........#.....E...........................................",
    "..........#.................................................",
    "..........#.................................................",
    "............................................................",
    "............................................................",
    "............................................................",
    "............................................................",
    "............................................................",
    "............................................................",
    "............................................................",
    "............................................................",
    "............................................................",
    "............................................................",
    "............................................................",
    "............................................................",
    "............................................................",
    "............................................................",
    "............................................................",
    "............................................................",
    "............................................................",
    "............................................................",
    "............................................................",
    "............................................................",
    "............................................................",
    "............................................................",
    "............................................................",
    "............................................................",
    "............................................................",
    "............................................................",
    "............................................................",
    "............................................................",
    "............................................................",
    "............................................................",
    "............................................................",
    "............................................................",
    "............................................................",
    "............................................................",
    "............................................................",
    "............................................................",
    "............................................................",
    "............................................................",
    "............................................................",
    "............................................................",
    "............................................................"
  ]
}