{
  "resolution": 0.05,
  "width": 60,
  "height": 60,
  "cells": [
    "............................................................",
    "............................................................",
    "............................................................",
    "............................................................",
    "............................................................",
    "....S.......................................................",
    "............................................................",
    "............................................................",
    "............................................................",
    "............................................................",
    "........###############.....................................",
    ".........##############.....................................",
    "..........#############.....................................",
    "............###########.....................................",
    ".............##########.....................................",
    "..............#########.....................................",
    "...............########.....................................",
    "................######......................................",
    ".................#####......................................",
    "..................####......................................",
    "...................###.............#####....................",
    "....................##.............#####....................",
    ".....................#.............#####....................",
    "...................................#####....................",
    "...................................#####....................",
    "...................................#####....................",
    "...................................#####....................",
    "...................................#####....................",
    "............................................................",
    "............................................................",
    "....................#############...............############",
    "....................#############...............############",
    "....................#############...............############",
    "....................#############...............############",
    "....................#############...............############",
    "....................#############...............############",
    "....................#############...............############",
    "....................#############...............############",
    "....................#############...............############",
    "....................#############...............############",
    "....................#############...............############",
    "....................#############...............############",
    "....................#############...........................",
    "....................#############...........................",
    "............................................................",
    "................................................######......",
    "................................................######......",
    "................................................######......",
    "............................................................",
    "..................................................E.........",
    "............................................................",
    "............................................................",
    "............................................................",
    "............................................................",
    "............................................................",
    "............................................................",
    "............................................................",
    "............................................................",
    "............................................................",
    "............................................................"
  ]
}

